"a" = (/turf/simulated/floor/plating/asteroid/basalt/lava_land_surface,/area/lavaland/surface/outdoors)
"b" = (/turf/simulated/mineral/volcanic/lava_land_surface,/area/lavaland/surface/outdoors)
"c" = (/turf/simulated/floor/plating/lava/smooth/lava_land_surface,/area/lavaland/surface/outdoors)
"d" = (/obj/effect/baseturf_helper/lava_land/surface,/turf/simulated/floor/mineral/silver,/area/ruin/powered/pride)
"e" = (/obj/structure/mirror{pixel_x = -32},/turf/simulated/floor/mineral/silver,/area/ruin/powered/pride)
"f" = (/obj/structure/mirror{pixel_x = 32},/turf/simulated/floor/mineral/silver,/area/ruin/powered/pride)
"g" = (/turf/simulated/floor/mineral/silver,/area/ruin/powered/pride)
"h" = (/obj/structure/mirror{pixel_x = -32},/obj/machinery/light/small{dir = 1},/obj/effect/spawner/lootdrop/artifactL,/turf/simulated/floor/mineral/silver,/area/ruin/powered/pride)
"i" = (/obj/structure/mirror{pixel_x = 32},/obj/machinery/light/small{dir = 1},/obj/effect/spawner/lootdrop/artifactH,/turf/simulated/floor/mineral/silver,/area/ruin/powered/pride)
"l" = (/obj/structure/mirror{pixel_x = -32},/obj/machinery/light/small{brightness_range = 3; dir = 8},/turf/simulated/floor/mineral/silver,/area/ruin/powered/pride)
"m" = (/obj/structure/mirror{pixel_x = 32},/obj/machinery/light/small{dir = 4},/turf/simulated/floor/mineral/silver,/area/ruin/powered/pride)
"r" = (/obj/machinery/light/small,/turf/simulated/floor/mineral/silver,/area/ruin/powered/pride)
"G" = (/turf/simulated/wall/mineral/diamond,/area/ruin/powered/pride)
"O" = (/obj/structure/mirror/magic/pride,/turf/simulated/wall/mineral/diamond,/area/ruin/powered/pride)
"Y" = (/obj/machinery/door/airlock/diamond,/turf/simulated/floor/mineral/silver{blocks_air = 1},/area/ruin/powered/pride)

(1,1,1) = {"
aabcccccbb
aaccGGGccb
accGGGGGcc
acGGGGGGGc
acGGGGGGGc
acGhGGGiGc
acGegOgfGc
acGegggfGc
acGlgggmGc
acGegggfGc
acGegdgfGc
acGlgggmGc
acGegggfGc
acGegggfGc
acGlgggmGc
acGegggfGc
acGergrfGc
acGGGYGGGc
acccaacccc
aaaaaaaaaa
"}
