"a" = (/turf/template_noop,/area/lavaland/surface/outdoors)
"b" = (/turf/simulated/mineral/volcanic/lava_land_surface,/area/lavaland/surface/outdoors)
"c" = (/turf/simulated/floor/plating/asteroid/basalt/lava_land_surface,/area/lavaland/surface/outdoors)
"d" = (/obj/mecha/working/ripley/mining{ruin_mecha = 1},/turf/simulated/floor/plating/asteroid/basalt/lava_land_surface,/area/lavaland/surface/outdoors)
"e" = (/obj/item/clothing/shoes/workboots/mining,/obj/item/clothing/under/rank/miner/lavaland,/obj/effect/decal/remains/human,/turf/simulated/floor/plating/asteroid/basalt/lava_land_surface,/area/lavaland/surface/outdoors)
"f" = (/obj/effect/spawner/lootdrop/artifactH,/turf/simulated/floor/plating/asteroid/basalt/lava_land_surface,/area/lavaland/surface/outdoors)

(1,1,1) = {"
abbbb
bccfb
bbdcb
bcebb
abbba
"}
