"a" = (/turf/unsimulated/wall,/area/ruin/unpowered)
"b" = (/turf/simulated/floor/plating/lava/smooth/lava_land_surface,/area/ruin/unpowered)
"c" = (/obj/item/paper/fluff/stations/lavaland/sloth/note,/turf/simulated/floor/sepia{blocks_air = 0; slowdown = 10},/area/ruin/unpowered)
"d" = (/turf/simulated/floor/sepia{blocks_air = 0; slowdown = 10},/area/ruin/unpowered)
"e" = (/obj/machinery/door/airlock/wood,/turf/simulated/floor/sepia{blocks_air = 0; slowdown = 10},/area/ruin/unpowered)
"f" = (/obj/structure/table/wood,/obj/item/reagent_containers/food/snacks/grown/citrus/orange,/turf/simulated/floor/sepia{blocks_air = 0; slowdown = 10},/area/ruin/unpowered)
"g" = (/obj/structure/bed,/obj/item/bedsheet/brown,/obj/effect/spawner/lootdrop/artifactH,/turf/simulated/floor/sepia{blocks_air = 0; slowdown = 10},/area/ruin/unpowered)
"h" = (/obj/effect/baseturf_helper/lava_land/surface,/turf/simulated/floor/sepia{blocks_air = 0; slowdown = 10},/area/ruin/unpowered)

(1,1,1) = {"
aaaaaaaaaaaaaaaaaaaaaaaaaaaaaaaaaaaaaaaaaaaaaaaaaa
abbbbbbbbbbbbbbbbbbbbbbbbbbbbbbbbbbbbbbbbbbbbbbbba
abaaaaaaaaaaaaaaaaaaaaaaaaaaaaaaaaaaaaaaaaaaaaaaaa
abacdddadddadddadddadddadddadddadddadddadddadddada
abaddadadadadadadadadadahadadadadadadadadadadadade
abaddadadadadadadadadadadadadadadadadadadadadadade
abafgadddadddadddadddadddadddadddadddadddadddaddda
abaaaaaaaaaaaaaaaaaaaaaaaaaaaaaaaaaaaaaaaaaaaaaaaa
abbbbbbbbbbbbbbbbbbbbbbbbbbbbbbbbbbbbbbbbbbbbbbbba
aaaaaaaaaaaaaaaaaaaaaaaaaaaaaaaaaaaaaaaaaaaaaaaaaa
"}
