"a" = (/turf/template_noop,/area/template_noop)
"b" = (/turf/simulated/floor/plating/asteroid/basalt/lava_land_surface,/area/lavaland/surface/outdoors/unexplored)
"c" = (/obj/item/clockwork/alloy_shards/small,/turf/simulated/floor/plating/asteroid/basalt/lava_land_surface,/area/lavaland/surface/outdoors/unexplored)
"d" = (/obj/structure/clockwork/wall_gear,/turf/simulated/floor/plating/asteroid/basalt/lava_land_surface,/area/lavaland/surface/outdoors/unexplored)
"e" = (/obj/item/stack/tile/brass,/turf/simulated/floor/clockwork{oxygen = 14; nitrogen = 23; temperature = 300},/area/lavaland/surface/outdoors/unexplored)
"f" = (/turf/simulated/mineral/volcanic/lava_land_surface,/area/lavaland/surface/outdoors/unexplored)
"g" = (/obj/item/clockwork/alloy_shards/medium/gear_bit,/turf/simulated/floor/plating/asteroid/basalt/lava_land_surface,/area/lavaland/surface/outdoors/unexplored)
"h" = (/turf/simulated/floor/clockwork{oxygen = 14; nitrogen = 23; temperature = 300},/area/lavaland/surface/outdoors/unexplored)
"i" = (/obj/structure/grille/ratvar/broken,/turf/simulated/floor/plating/asteroid/basalt/lava_land_surface,/area/lavaland/surface/outdoors/unexplored)
"j" = (/turf/simulated/wall/clockwork,/area/lavaland/surface/outdoors/unexplored)
"k" = (/obj/item/clockwork/alloy_shards/small,/turf/simulated/floor/clockwork{oxygen = 14; nitrogen = 23; temperature = 300},/area/lavaland/surface/outdoors/unexplored)
"l" = (/turf/simulated/floor/plating/lava/smooth/lava_land_surface,/area/lavaland/surface/outdoors/unexplored)
"m" = (/obj/item/clockwork/alloy_shards/medium,/turf/simulated/floor/plating/asteroid/basalt/lava_land_surface,/area/lavaland/surface/outdoors/unexplored)
"n" = (/obj/item/clockwork/component/belligerent_eye/blind_eye,/turf/simulated/floor/plating/asteroid/basalt/lava_land_surface,/area/lavaland/surface/outdoors/unexplored)
"o" = (/obj/item/clockwork/alloy_shards/large,/turf/simulated/floor/plating/asteroid/basalt/lava_land_surface,/area/lavaland/surface/outdoors/unexplored)
"p" = (/obj/item/clockwork/alloy_shards/medium,/turf/simulated/floor/clockwork{oxygen = 14; nitrogen = 23; temperature = 300},/area/lavaland/surface/outdoors/unexplored)
"q" = (/obj/structure/lattice/catwalk/clockwork,/turf/simulated/floor/plating/lava/smooth/lava_land_surface,/area/lavaland/surface/outdoors/unexplored)
"r" = (/obj/structure/lattice/clockwork,/turf/simulated/floor/plating/asteroid/basalt/lava_land_surface,/area/lavaland/surface/outdoors/unexplored)
"s" = (/obj/item/clockwork/alloy_shards/large,/turf/simulated/floor/clockwork{oxygen = 14; nitrogen = 23; temperature = 300},/area/lavaland/surface/outdoors/unexplored)
"t" = (/obj/item/stack/tile/brass,/turf/simulated/floor/plating/asteroid/basalt/lava_land_surface,/area/lavaland/surface/outdoors/unexplored)
"u" = (/obj/structure/grille/ratvar,/turf/simulated/floor/clockwork{oxygen = 14; nitrogen = 23; temperature = 300},/area/lavaland/surface/outdoors/unexplored)
"v" = (/obj/item/clockwork/alloy_shards/medium,/obj/structure/lattice/clockwork,/turf/simulated/floor/plating/asteroid/basalt/lava_land_surface,/area/lavaland/surface/outdoors/unexplored)
"w" = (/obj/structure/grille/ratvar/broken,/turf/simulated/floor/clockwork{oxygen = 14; nitrogen = 23; temperature = 300},/area/lavaland/surface/outdoors/unexplored)
"x" = (/obj/structure/clockwork/wall_gear,/obj/item/stack/tile/brass,/turf/simulated/floor/clockwork{oxygen = 14; nitrogen = 23; temperature = 300},/area/lavaland/surface/outdoors/unexplored)
"y" = (/obj/item/clockwork/component/geis_capacitor/fallen_armor,/turf/simulated/floor/clockwork{oxygen = 14; nitrogen = 23; temperature = 300},/area/lavaland/surface/outdoors/unexplored)
"z" = (/obj/structure/clockwork/wall_gear,/turf/simulated/floor/clockwork{oxygen = 14; nitrogen = 23; temperature = 300},/area/lavaland/surface/outdoors/unexplored)
"A" = (/obj/item/clockwork/alloy_shards/clockgolem_remains,/turf/simulated/floor/clockwork{oxygen = 14; nitrogen = 23; temperature = 300},/area/lavaland/surface/outdoors/unexplored)
"B" = (/obj/item/clockwork/weapon/ratvarian_spear,/turf/simulated/floor/clockwork{oxygen = 14; nitrogen = 23; temperature = 300},/area/lavaland/surface/outdoors/unexplored)
"C" = (/obj/item/clockwork/alloy_shards/medium/gear_bit,/turf/simulated/floor/clockwork{oxygen = 14; nitrogen = 23; temperature = 300},/area/lavaland/surface/outdoors/unexplored)
"D" = (/obj/structure/grille/ratvar,/turf/simulated/floor/plating/asteroid/basalt/lava_land_surface,/area/lavaland/surface/outdoors/unexplored)
"E" = (/obj/item/clockwork/alloy_shards/clockgolem_remains,/turf/simulated/floor/plating/asteroid/basalt/lava_land_surface,/area/lavaland/surface/outdoors/unexplored)
"F" = (/obj/structure/dead_ratvar,/turf/simulated/floor/clockwork{oxygen = 14; nitrogen = 23; temperature = 300},/area/lavaland/surface/outdoors/unexplored)
"G" = (/obj/item/stack/tile/brass/fifty,/turf/simulated/floor/plating/asteroid/basalt/lava_land_surface,/area/lavaland/surface/outdoors/unexplored)
"H" = (/obj/effect/spawner/lootdrop/artifactH,/turf/simulated/floor/plating/asteroid/basalt/lava_land_surface,/area/lavaland/surface/outdoors/unexplored)
"I" = (/obj/effect/spawner/lootdrop/artifactL,/turf/simulated/floor/clockwork{oxygen = 14; nitrogen = 23; temperature = 300},/area/lavaland/surface/outdoors/unexplored)
"J" = (/obj/effect/spawner/lootdrop/artifactM,/turf/simulated/floor/clockwork{oxygen = 14; nitrogen = 23; temperature = 300},/area/lavaland/surface/outdoors/unexplored)

(1,1,1) = {"
aaaaaaaaabcdebbfbbbbgcbaaaaaaaaa
aaaaaaahbhijkbblbhblbchaaaaaaaaa
aaaaaabhcljjbbblbllllbmbaaaaaaaa
aaaaahbgbljjlmllllllllnblcbaaaaa
aaaaacbcbllhllllllllllbllbhcbaaa
aaaabhlblllllllllblblbhlllbbbgaa
aafflmllllllblllbbhblhllllllfcaa
aobllllllllbpbhqlhbprhojjllbcbba
abllpllllbllshhbqbhhhtjjllllblla
aabrhchltbbqrhhhrhhcrbuqllllllba
ahvHclbnhphrhkhhhhhhhhrpblllcbaa
abbblllhbrkhhhhhhhhkhhphhglllmba
arpllllrhFhhhhhhhhhhhhhmrqllllla
bcwjllllwbhhhhhhhhhhhhrexblllbca
sjjjjwllphhchhkhhrhoyhIzhhllllfc
hxjjlllbbArqhJBsbkrblmbjllllcffa
bbcpblllgbllhchbsbjllbljlllbobaa
ablllllllllblbllrChllllllllllaaa
agbblmlllllllllllrcllllllclfbaaa
aabhDcclblllllllrhhbllbclmbaaaaa
aaachhffbmlblblllbrElhbllbaaaaaa
aaarrffbbllhbbbflbhrjjwlaaaaaaaa
aaaaaabablbobhbfbmbGjjrbaaaaaaaa
aaaaaaaaaaaaabaaabborjbaaaaaaaaa
"}
