"a" = (/turf/template_noop,/area/template_noop)
"b" = (/obj/structure/alien/weeds,/obj/structure/alien/resin/wall,/turf/simulated/floor/plating/asteroid/basalt/lava_land_surface,/area/ruin/unpowered/xenonest)
"c" = (/obj/structure/alien/weeds,/obj/effect/baseturf_helper/lava_land/surface,/turf/simulated/floor/plating/asteroid/basalt/lava_land_surface,/area/ruin/unpowered/xenonest)
"d" = (/obj/structure/alien/resin/wall,/obj/structure/alien/weeds,/turf/simulated/floor/plating/asteroid/basalt/lava_land_surface,/area/ruin/unpowered/xenonest)
"e" = (/obj/structure/alien/weeds,/obj/structure/alien/egg/burst,/turf/simulated/floor/plating/asteroid/basalt/lava_land_surface,/area/ruin/unpowered/xenonest)
"f" = (/obj/structure/alien/weeds,/obj/structure/alien/weeds,/turf/simulated/floor/plating/asteroid/basalt/lava_land_surface,/area/ruin/unpowered/xenonest)
"g" = (/obj/structure/alien/weeds,/turf/simulated/floor/plating/asteroid/basalt/lava_land_surface,/area/ruin/unpowered/xenonest)
"h" = (/obj/structure/alien/weeds,/obj/structure/alien/resin/wall,/obj/effect/spawner/lootdrop/artifactMR,/turf/simulated/floor/plating/asteroid/basalt/lava_land_surface,/area/ruin/unpowered/xenonest)
"i" = (/obj/structure/alien/weeds,/obj/structure/bed/nest,/turf/simulated/floor/plating/asteroid/basalt/lava_land_surface,/area/ruin/unpowered/xenonest)
"j" = (/obj/structure/alien/weeds,/mob/living/simple_animal/hostile/alien,/turf/simulated/floor/plating/asteroid/basalt/lava_land_surface,/area/ruin/unpowered/xenonest)
"k" = (/obj/structure/alien/weeds,/obj/structure/alien/resin/wall,/obj/effect/spawner/lootdrop/artifactH,/turf/simulated/floor/plating/asteroid/basalt/lava_land_surface,/area/ruin/unpowered/xenonest)
"l" = (/obj/structure/alien/weeds/node,/turf/simulated/floor/plating/asteroid/basalt/lava_land_surface,/area/ruin/unpowered/xenonest)
"o" = (/obj/structure/alien/weeds,/obj/structure/bed/nest,/obj/effect/decal/cleanable/blood/gibs,/obj/item/gun/projectile/automatic/pistol,/turf/simulated/floor/plating/asteroid/basalt/lava_land_surface,/area/ruin/unpowered/xenonest)
"r" = (/obj/structure/alien/weeds,/obj/structure/alien/resin/wall,/obj/structure/alien/resin/wall,/turf/simulated/floor/plating/asteroid/basalt/lava_land_surface,/area/ruin/unpowered/xenonest)
"t" = (/obj/structure/alien/weeds,/mob/living/simple_animal/hostile/alien/sentinel,/turf/simulated/floor/plating/asteroid/basalt/lava_land_surface,/area/ruin/unpowered/xenonest)
"u" = (/obj/structure/alien/weeds,/obj/effect/decal/cleanable/blood/gibs,/turf/simulated/floor/plating/asteroid/basalt/lava_land_surface,/area/ruin/unpowered/xenonest)
"v" = (/obj/structure/alien/weeds/node,/obj/effect/decal/cleanable/blood,/turf/simulated/floor/plating/asteroid/basalt/lava_land_surface,/area/ruin/unpowered/xenonest)
"w" = (/obj/structure/alien/weeds,/obj/structure/bed/nest,/obj/structure/alien/resin/wall,/turf/simulated/floor/plating/asteroid/basalt/lava_land_surface,/area/ruin/unpowered/xenonest)
"y" = (/obj/structure/alien/weeds/node,/obj/structure/alien/resin/wall,/turf/simulated/floor/plating/asteroid/basalt/lava_land_surface,/area/ruin/unpowered/xenonest)
"z" = (/obj/structure/alien/weeds,/obj/structure/bed/nest,/obj/effect/decal/cleanable/blood/gibs,/obj/item/clothing/under/rank/security,/obj/item/clothing/suit/armor/vest,/obj/item/melee/baton/loaded,/obj/item/clothing/head/helmet,/turf/simulated/floor/plating/asteroid/basalt/lava_land_surface,/area/ruin/unpowered/xenonest)
"B" = (/obj/structure/alien/weeds,/obj/structure/alien/egg/burst,/obj/effect/decal/cleanable/blood/gibs,/turf/simulated/floor/plating/asteroid/basalt/lava_land_surface,/area/ruin/unpowered/xenonest)
"C" = (/obj/structure/alien/weeds,/obj/structure/alien/egg/burst,/obj/effect/decal/cleanable/blood,/turf/simulated/floor/plating/asteroid/basalt/lava_land_surface,/area/ruin/unpowered/xenonest)
"E" = (/obj/structure/alien/weeds,/mob/living/simple_animal/hostile/alien/drone{plants_off = 1},/turf/simulated/floor/plating/asteroid/basalt/lava_land_surface,/area/ruin/unpowered/xenonest)
"F" = (/obj/structure/alien/weeds,/mob/living/simple_animal/hostile/alien/queen/large{desc = "A gigantic alien who is in charge of the hive and all of its loyal servants."; name = "alien queen"; pixel_x = -16; plants_off = 1},/turf/simulated/floor/plating/asteroid/basalt/lava_land_surface,/area/ruin/unpowered/xenonest)
"G" = (/turf/simulated/floor/plating/lava/smooth/lava_land_surface,/area/lavaland/surface/outdoors)
"H" = (/obj/structure/alien/weeds,/obj/effect/decal/cleanable/blood,/turf/simulated/floor/plating/asteroid/basalt/lava_land_surface,/area/ruin/unpowered/xenonest)
"I" = (/obj/structure/alien/weeds,/obj/structure/bed/nest,/obj/effect/decal/cleanable/blood/gibs,/obj/effect/decal/cleanable/blood,/obj/item/clothing/under/syndicate,/obj/item/clothing/glasses/night,/turf/simulated/floor/plating/asteroid/basalt/lava_land_surface,/area/ruin/unpowered/xenonest)
"K" = (/obj/structure/alien/weeds/node,/mob/living/simple_animal/hostile/alien,/turf/simulated/floor/plating/asteroid/basalt/lava_land_surface,/area/ruin/unpowered/xenonest)
"L" = (/obj/structure/alien/weeds/node,/mob/living/simple_animal/hostile/alien/drone{plants_off = 1},/turf/simulated/floor/plating/asteroid/basalt/lava_land_surface,/area/ruin/unpowered/xenonest)
"M" = (/obj/structure/alien/weeds,/obj/structure/bed/nest,/obj/effect/decal/cleanable/blood/gibs,/obj/item/tank/emergency_oxygen,/obj/item/clothing/suit/space/syndicate/orange,/obj/item/clothing/mask/gas,/obj/item/clothing/head/helmet/space/syndicate/orange,/turf/simulated/floor/plating/asteroid/basalt/lava_land_surface,/area/ruin/unpowered/xenonest)
"O" = (/obj/structure/alien/weeds/node,/turf/template_noop,/area/ruin/unpowered/xenonest)
"Q" = (/obj/structure/alien/weeds,/obj/effect/decal/cleanable/blood,/mob/living/simple_animal/hostile/alien/drone{plants_off = 1},/turf/simulated/floor/plating/asteroid/basalt/lava_land_surface,/area/ruin/unpowered/xenonest)
"R" = (/obj/structure/alien/weeds,/turf/template_noop,/area/ruin/unpowered/xenonest)

(1,1,1) = {"
aaaaaaaaaaaaaaaaaaabbddbaaaaaaaaaaaaaaaaaaa
aaaaaaaaaaaaaaaaaaabefgbbaaaaaaaaaaaaaaaaaa
aaGGGGGGGGGGaaaaaaabijeibaaaaaaaaaaaaaaaaaa
GGGbbbhbbbbGGGaaaaabbglibaaaaaaaaaaaaaaaaaa
GbbbggeiogbbbGGaaaaabbgbbaaaaaaaaaaaaaaabbr
GbggggtuvugebbGGaaaabbgbaaabbbbaaaaaaabbbeb
Gbegywgbgbtggbbbbbbabggbaabbzibaaaaaabbiegb
GbegbgggbgggggblEgbbbgbbaabBCubbbbbbbbgEggb
GbbgbFglgggglgblgggbbgbbbbbgjgggglgggggglib
GbgEbuHgggtgggbbbEggggggEggggibbbbbbbbeggib
GbggyIuteygggbbGbbglggbbbggleibaaaaaabbgebb
GbbebbgebeggbbGGGbbgggbabbbeibbaaaaaabbgbba
GGbbbbbbbbbbbGGabbgggbbaaabbbbaaaaaaabggbaa
aGGGGGGGGGGGGGaabgggbbaaaaaaaaaaaaaaabgbbaa
aaaaaaaaaaaaaaaabgcbbaaaaaaaaaaaaaaaabKbaaa
aaaaaaaaaaaaaaaabggbaaaaaaaaaaaaaaaabbgbaaa
aaaaaaaaaaaaaaaabggbaaaaaaabbbbbbaakbggbaaa
aaaaaaaaaaaaaaaabggbbbbbbbbbggggbbbbggbbaaa
aaaaaaaaaaaaaaaabglgbgggggbggbbglggggbbaaaa
aaaaaaaaaaaaaaaabbggggggLgggbbbbbbbbbbaaaaa
aaaaaaaaaaaaaaabkbggggbbbggbbaaaaaaaaaaaaaa
aaaaaaaaaaaaaabbgggbbbbabggbbaaaaaaaaaaaaaa
aaaaaaaaaaaaaabggbbbaaaabbggbbaaaaaaaaaaaaa
aaaaaaaaaaaabbbjbbaaaaaaabgggbaaaaaaaaaaaaa
aaaaaaaaaaabbiggbaaaaaaaabbglbaaaaaaaaaaaaa
aaaaaaaaaabbeggebaaaaaaaaabbbbaaaaaaaaaaaaa
aaaaaaaaaabMulgbbaaaaaaaaabOObaabbaaaaaaaaa
aaaaaaaaaabiQgibaaaaaaaaaabRRybbbaaaaaaaaaa
aaaaaaaaaabbgebbaaaaaaaaabyggggggaaaaaaaaaa
aaaaaaaaaaabbbbaaaaaaaaabbggggggaaaaaaaaaaa
"}
