"a" = (/turf/template_noop,/area/template_noop)
"b" = (/turf/simulated/floor/engine/cult{oxygen = 24; nitrogen = 23; temperature = 300},/area/ruin/unpowered)
"c" = (/turf/simulated/floor/plating/lava/smooth/lava_land_surface,/area/ruin/unpowered)
"d" = (/turf/simulated/wall/cult,/area/ruin/unpowered)
"e" = (/obj/effect/decal/remains/human,/turf/simulated/floor/plating/asteroid/basalt/lava_land_surface,/area/ruin/unpowered)
"f" = (/obj/structure/cult/pylon,/turf/simulated/floor/plating/asteroid/basalt/lava_land_surface,/area/ruin/unpowered)
"g" = (/obj/effect/decal/cleanable/blood/old,/turf/simulated/floor/engine/cult{oxygen = 24; nitrogen = 23; temperature = 300},/area/ruin/unpowered)
"h" = (/obj/effect/baseturf_helper/lava_land/surface,/turf/simulated/wall/cult,/area/ruin/unpowered)
"i" = (/obj/effect/decal/remains/human,/obj/effect/decal/cleanable/blood/old,/turf/simulated/floor/engine/cult{oxygen = 24; nitrogen = 23; temperature = 300},/area/ruin/unpowered)
"j" = (/obj/effect/spawner/lootdrop/artifactMR,/turf/simulated/floor/engine/cult{oxygen = 24; nitrogen = 23; temperature = 300},/area/ruin/unpowered)
"k" = (/obj/effect/decal/remains/human,/obj/item/melee/cultblade,/turf/simulated/floor/engine/cult{oxygen = 24; nitrogen = 23; temperature = 300},/area/ruin/unpowered)
"l" = (/obj/effect/decal/remains/human,/obj/item/clothing/shoes/cult,/obj/item/clothing/suit/hooded/cultrobes,/turf/simulated/floor/engine/cult{oxygen = 24; nitrogen = 23; temperature = 300},/area/ruin/unpowered)
"m" = (/obj/effect/decal/remains/human,/turf/simulated/floor/engine/cult{oxygen = 24; nitrogen = 23; temperature = 300},/area/ruin/unpowered)
"n" = (/obj/effect/spawner/lootdrop/artifactH,/turf/simulated/wall/cult,/area/ruin/unpowered)
"o" = (/obj/effect/rune/narsie{color = "#ff0000"; used = 1},/obj/item/cult_shift,/obj/effect/decal/remains/human,/obj/item/melee/cultblade/dagger,/obj/effect/step_trigger/sound_effect{happens_once = 1; name = "a grave mistake"; sound = 'sound/hallucinations/i_see_you1.ogg'; triggerer_only = 1},/obj/effect/step_trigger/message{message = "<span class='cult italic'><b><span class='big'>You've made a grave mistake, haven't you?</span></b></span>"; name = "ohfuck"},/turf/simulated/floor/engine/cult{oxygen = 24; nitrogen = 23; temperature = 300},/area/ruin/unpowered)
"q" = (/obj/effect/decal/remains/human,/obj/item/clothing/shoes/cult,/obj/item/clothing/suit/hooded/cultrobes,/obj/effect/decal/cleanable/blood/old,/turf/simulated/floor/engine/cult{oxygen = 24; nitrogen = 23; temperature = 300},/area/ruin/unpowered)
"s" = (/turf/simulated/floor/plating/asteroid/basalt/lava_land_surface,/area/ruin/unpowered)

(1,1,1) = {"
aaaaaabcbaaaaaa
adecscbbbcsceda
aefsdccgccdsfea
acsccccbccccsca
asdccbgbbgccdsa
acccbbidkbbccca
bbccblbbbmbccbb
cbgbbdbobhbbgbc
bbccbkbbbqbccjb
acccbbldmbbccca
asnccbbbbbccdsa
aceccccbcccceca
asfedccgccdefsa
adscscbbbcscsda
aaaaaabcbaaaaaa
"}
