"a" = (/turf/space,/area/space)
"b" = (/turf/simulated/mineral,/area/ruin/unpowered)
"c" = (/turf/simulated/mineral,/area/space/nearstation)
"d" = (/turf/simulated/floor/plating/asteroid/airless,/area/ruin/unpowered)
"e" = (/turf/simulated/wall,/area/ruin/unpowered)
"f" = (/turf/simulated/wall/rust,/area/ruin/unpowered)
"g" = (/turf/simulated/floor/plating,/area/ruin/unpowered)
"h" = (/obj/structure/closet/crate,/turf/simulated/floor/plating,/area/ruin/unpowered)
"i" = (/obj/effect/spawner/lootdrop/crate_spawner,/turf/simulated/floor/plating,/area/ruin/unpowered)
"j" = (/obj/structure/barricade/wooden,/obj/structure/door_assembly,/turf/simulated/floor/plating,/area/ruin/unpowered)
"k" = (/obj/item/archaeology/artifact/rare,/turf/simulated/floor/plating,/area/ruin/unpowered)
"l" = (/obj/effect/decal/remains/human,/turf/simulated/floor/plating,/area/ruin/unpowered)
"m" = (/obj/structure/table,/obj/item/storage/toolbox/syndicate,/turf/simulated/floor/plating,/area/ruin/unpowered)
"n" = (/obj/structure/table,/turf/simulated/floor/plating,/area/ruin/unpowered)
"o" = (/obj/structure/barricade/wooden,/turf/simulated/floor/plating,/area/ruin/unpowered)
"p" = (/obj/structure/barricade/wooden,/obj/machinery/door/airlock/external,/turf/simulated/floor/plating/asteroid/airless,/area/ruin/unpowered)
"q" = (/obj/machinery/door/airlock/external,/turf/simulated/floor/plating,/area/ruin/unpowered)
"r" = (/turf/simulated/floor/plating/asteroid/airless,/area/space/nearstation)
"s" = (/obj/structure/table,/obj/item/storage/toolbox/electrical,/obj/effect/spawner/lootdrop/artifactH,/turf/simulated/floor/plating,/area/ruin/unpowered)
"t" = (/obj/structure/closet/crate,/obj/effect/spawner/lootdrop/artifactM,/turf/simulated/floor/plating,/area/ruin/unpowered)

(1,1,1) = {"
aaaaaaaaaaaaaaaaaaaaaaaaaaaaaaaaaaaaaaaa
aaaaaaaaaaaaaaaaaaaaaaaaaaaaaaaaaaaaaaaa
aaaaaaaaaaaaaaaaaaaaaaaaaaaaaaabbabbaaaa
aaaaaaaaaaaaaaaaaaaaaaaaacaaaabbbbaaaaaa
aaaaaaaaaaaaaaaaaaaaaaaaaaaaaabbbbaaaaaa
aaaaaaaaaaaaaaaaaaaaaaaaaaaaaaaabbaaaaaa
aaaaaaaaaaabbbbbaaaaaaaaaaaaaaaaaaaabaaa
aaaaaaaabbbbbbbbaaaaaaaaaaaaaaaaaaaaaaaa
aaaaaaabbbbbbbbbbbbaaaaaaaaaaaaaaaaaaaaa
aaaaaadbbbbbbbbbbbbbbbaaaaaaaaaaaabaaaaa
aaaaaadbbbbbbbbbbbbbbbbbaaaaaaaaaaaaaaaa
aaaaaddbbbbbbbbbeefbbeebbbbbbbaaaaaaaaaa
aaaaaddbbbbbbbbgggeggghfibbbbbbbaaaaaaaa
aaaaaddddbbbbbfiggjgkghfhebbbbbbaaaaaaaa
aaaaaddddbbbbbfigsfigggjgfbbbbbbbbaaaaaa
aaaaaaaddbbbbbelgmfhggnffebbbbbbbbaaaaaa
aaaaaaadddbbbbfgtieiggggibbbbbbbbbbbaaaa
aaaaaaaaddbbbbeffeeeejeeebbbbbbbbbbbaaaa
aaaaaaaaddbbbbegggdggggdebbbbbbbbbbbaaaa
aaaaaaaaddddbbegggigdgdobbbbbbbbbbbbaaaa
aaabaaaaadddddbbebeffeepebbbbbbbbbbbaaaa
aaaaaaaaaaadddbbbbbbbbeoebbbbbbbbbbbbaaa
aaaaaaaaaaadddddddbbbbeqebbbbbbbbbbbbaaa
aaaaaaaaaaaaadddddbbbbbdbbbbbbbbbbbbbaaa
aaaaabaaaaaaadddddddddddddbbbbbbbbbbbaaa
aaaaaaaaaaaaaaaaadddddddddbccbbbbbbbbaaa
aaaaaaabbaaaaaaaaaddddddddbccbbbbbbbbaaa
aaaaaaabbbbaaaaaaarrrrrrrrrccddbbbbbbaaa
aaaaaaabbbbaaaaaaarrdddddddddddddbbbbbaa
aaaaaaaaabbaaaaaaaaddddddddddddddbbbbbaa
aaaaaaaaabbaaaaaaaaddddddddddddddbbbbbaa
aaaaaaaaaaaaaaaaaaaddddddddddddddbbbbbaa
aaaaaaaaaaaaaaaaabbdddddddddddddddbbbbaa
abbaaaaaaaaaaaaaabbdddddddddddddddbbbbaa
abbaaaaaaaaaaaaaabbbbdddddddddddbbbbbbaa
abbbaaaaaaaaaaaaaabbbdddddddddddbbbbbaaa
aaaaaaaaaaaaaaaaaabbbbbbbdddddbbbbbbbaaa
aaaaaaaaaaaaaaaaaaaabbbbbbddddbbbbbbbaaa
aaaaabaaaaaaaaaaaaaabbbbbbbbbbbbbbaaaaaa
aaabaaaaaaaaaaaaaaaaaabbbbbbbbbaaaaaaaaa
"}
