"a" = (/turf/space,/area/space)
"b" = (/obj/structure/window/reinforced{tag = "icon-rwindow (EAST)"; icon_state = "rwindow"; dir = 4},/turf/space,/area/space/nearstation)
"c" = (/obj/machinery/door/airlock/external,/turf/simulated/floor/plating,/area/ruin/powered)
"d" = (/obj/structure/window/reinforced{tag = "icon-rwindow (WEST)"; icon_state = "rwindow"; dir = 8},/turf/space,/area/space/nearstation)
"e" = (/obj/structure/window/reinforced{tag = "icon-rwindow (EAST)"; icon_state = "rwindow"; dir = 4},/obj/structure/window/reinforced{tag = "icon-rwindow (WEST)"; icon_state = "rwindow"; dir = 8},/turf/simulated/floor/plating,/area/ruin/powered)
"f" = (/turf/simulated/wall,/area/ruin/powered)
"g" = (/obj/structure/grille,/obj/structure/window/full/reinforced,/turf/simulated/floor/plating,/area/ruin/powered)
"h" = (/obj/machinery/light/small{tag = "icon-bulb1 (NORTH)"; icon_state = "bulb1"; dir = 1},/turf/simulated/floor/plasteel,/area/ruin/powered)
"i" = (/turf/simulated/floor/plasteel,/area/ruin/powered)
"j" = (/obj/machinery/light/small{tag = "icon-bulb1 (EAST)"; icon_state = "bulb1"; dir = 4},/turf/simulated/floor/plasteel,/area/ruin/powered)
"k" = (/obj/structure/window/reinforced,/turf/space,/area/space/nearstation)
"l" = (/obj/structure/window/reinforced,/obj/structure/window/reinforced{tag = "icon-rwindow (NORTH)"; icon_state = "rwindow"; dir = 1},/turf/simulated/floor/plating,/area/ruin/powered)
"m" = (/obj/structure/chair{tag = "icon-chair (EAST)"; icon_state = "chair"; dir = 4},/obj/effect/decal/remains/human,/turf/simulated/floor/plasteel,/area/ruin/powered)
"n" = (/obj/structure/table,/obj/item/candle{pixel_y = 5},/obj/item/trash/plate{pixel_x = 10},/obj/item/trash/plate{pixel_x = -10},/turf/simulated/floor/plasteel,/area/ruin/powered)
"o" = (/obj/structure/chair{tag = "icon-chair (WEST)"; icon_state = "chair"; dir = 8},/obj/effect/decal/remains/human,/turf/simulated/floor/plasteel,/area/ruin/powered)
"p" = (/obj/structure/window/reinforced{tag = "icon-rwindow (NORTH)"; icon_state = "rwindow"; dir = 1},/turf/space,/area/space/nearstation)
"q" = (/obj/machinery/light/small{tag = "icon-bulb1 (WEST)"; icon_state = "bulb1"; dir = 8},/turf/simulated/floor/plasteel,/area/ruin/powered)
"r" = (/obj/machinery/light/small,/turf/simulated/floor/plasteel,/area/ruin/powered)
"s" = (/obj/effect/spawner/lootdrop/artifactH,/turf/simulated/floor/plasteel,/area/ruin/powered)

(1,1,1) = {"
aaaaaaaaaaaaaaaaaaaaaaaaaaaaaaaaaaaaaaaa
aaaaaaaaaaaaaaaaaaaaaaaaaaaaaaaaaaaaaaaa
aaaaaaaaaaaaaaaaaaaaaaaaaaaaaaaaaaaaaaaa
aaaaaaaaaaaaaaaaaaaaaaaaaaaaaaaaaaaaaaaa
aaaaaaaaaaaaaaaaaaaaaaaaaaaaaaaaaaaaaaaa
aaaaaaaaaaaaaaaaaaaaaaaaaaaaaaaaaaaaaaaa
aaaaaaaaaaaaaaaaaaaaaaaaaaaaaaaaaaaaaaaa
aaaaaaaaaaaaaaaaaaaaaaaaaaaaaaaaaaaaaaaa
aaaaaaaaaaaaaaaaaaaaaaaaaaaaaaaaaaaaaaaa
aaaaaaaaaaaaaaaaaaaaaaaaaaaaaaaaaaaaaaaa
aaaaaaaaaaaaaaaaaaaaaaaaaaaaaaaaaaaaaaaa
aaaaaaaaaaaaaaaaaaabcdaaaaaaaaaaaaaaaaaa
aaaaaaaaaaaaaaaaaaabedaaaaaaaaaaaaaaaaaa
aaaaaaaaaaaaaaaaaaabedaaaaaaaaaaaaaaaaaa
aaaaaaaaaaaaaaaaaaabedaaaaaaaaaaaaaaaaaa
aaaaaaaaaaaaaaaaaafgcgfaaaaaaaaaaaaaaaaa
aaaaaaaaaaaaaaaaafhiiiifaaaaaaaaaaaaaaaa
aaaaaaaaaaaaaaaafsiiiiijfaaaaaaaaaaaaaaa
aaaaaaaaaaaakkkkgiiiiiiigkkkkaaaaaaaaaaa
aaaaaaaaaaaaclllciimnoiiclllcaaaaaaaaaaa
aaaaaaaaaaaappppgiiiiiiigppppaaaaaaaaaaa
aaaaaaaaaaaaaaaafqiiiiiifaaaaaaaaaaaaaaa
aaaaaaaaaaaaaaaaafiiiirfaaaaaaaaaaaaaaaa
aaaaaaaaaaaaaaaaaafgcgfaaaaaaaaaaaaaaaaa
aaaaaaaaaaaaaaaaaaabedaaaaaaaaaaaaaaaaaa
aaaaaaaaaaaaaaaaaaabedaaaaaaaaaaaaaaaaaa
aaaaaaaaaaaaaaaaaaabedaaaaaaaaaaaaaaaaaa
aaaaaaaaaaaaaaaaaaabcdaaaaaaaaaaaaaaaaaa
aaaaaaaaaaaaaaaaaaaaaaaaaaaaaaaaaaaaaaaa
aaaaaaaaaaaaaaaaaaaaaaaaaaaaaaaaaaaaaaaa
aaaaaaaaaaaaaaaaaaaaaaaaaaaaaaaaaaaaaaaa
aaaaaaaaaaaaaaaaaaaaaaaaaaaaaaaaaaaaaaaa
aaaaaaaaaaaaaaaaaaaaaaaaaaaaaaaaaaaaaaaa
aaaaaaaaaaaaaaaaaaaaaaaaaaaaaaaaaaaaaaaa
aaaaaaaaaaaaaaaaaaaaaaaaaaaaaaaaaaaaaaaa
aaaaaaaaaaaaaaaaaaaaaaaaaaaaaaaaaaaaaaaa
aaaaaaaaaaaaaaaaaaaaaaaaaaaaaaaaaaaaaaaa
aaaaaaaaaaaaaaaaaaaaaaaaaaaaaaaaaaaaaaaa
aaaaaaaaaaaaaaaaaaaaaaaaaaaaaaaaaaaaaaaa
aaaaaaaaaaaaaaaaaaaaaaaaaaaaaaaaaaaaaaaa
"}
