"a" = (/turf/space,/area/space)
"b" = (/turf/simulated/mineral,/area/ruin/unpowered)
"c" = (/turf/simulated/floor/plating/asteroid/airless,/area/ruin/unpowered)
"d" = (/turf/simulated/mineral/random/high_chance,/area/ruin/unpowered)
"e" = (/turf/simulated/shuttle/wall,/area/ruin/unpowered)
"f" = (/obj/machinery/door/airlock/shuttle,/turf/simulated/floor/plating/airless,/area/ruin/unpowered)
"g" = (/turf/simulated/floor/plating/airless,/area/ruin/unpowered)
"h" = (/turf/simulated/floor/mineral/titanium/blue,/area/ruin/unpowered)
"i" = (/obj/structure/window/reinforced{tag = "icon-rwindow (WEST)"; icon_state = "rwindow"; dir = 8},/obj/structure/chair/comfy/shuttle,/turf/simulated/floor/mineral/titanium/blue,/area/ruin/unpowered)
"j" = (/obj/structure/chair/comfy/shuttle,/turf/simulated/floor/mineral/titanium/blue,/area/ruin/unpowered)
"k" = (/obj/effect/spawner/lootdrop/crate_spawner,/turf/simulated/floor/mineral/titanium/blue,/area/ruin/unpowered)
"l" = (/obj/structure/shuttle/engine/propulsion{dir = 4; icon_state = "propulsion"; tag = "icon-propulsion (WEST)"},/turf/simulated/shuttle/plating,/area/ruin/unpowered)
"m" = (/obj/item/shard,/turf/simulated/floor/plating/airless,/area/ruin/unpowered)
"n" = (/obj/structure/chair/comfy/shuttle{dir = 8},/turf/simulated/floor/plating/airless,/area/ruin/unpowered)
"o" = (/obj/structure/grille,/turf/simulated/floor/plating/airless,/area/ruin/unpowered)
"p" = (/obj/structure/table,/turf/simulated/floor/mineral/titanium/blue,/area/ruin/unpowered)
"q" = (/obj/item/shard,/obj/structure/chair/comfy/shuttle{dir = 8},/turf/simulated/floor/mineral/titanium/blue,/area/ruin/unpowered)
"r" = (/obj/structure/window/reinforced{tag = "icon-rwindow (WEST)"; icon_state = "rwindow"; dir = 8},/obj/structure/chair/comfy/shuttle{dir = 1},/turf/simulated/floor/mineral/titanium/blue,/area/ruin/unpowered)
"s" = (/obj/structure/chair/comfy/shuttle{dir = 1},/turf/simulated/floor/plating/airless,/area/ruin/unpowered)
"t" = (/obj/structure/girder,/turf/simulated/floor/plating/airless,/area/ruin/unpowered)
"u" = (/obj/item/archaeology/artifact/rare,/turf/simulated/floor/plating/airless,/area/ruin/unpowered)
"v" = (/obj/effect/spawner/lootdrop/artifactMR,/turf/simulated/floor/plating/airless,/area/ruin/unpowered)
"w" = (/obj/effect/spawner/lootdrop/artifactH,/turf/simulated/floor/plating/airless,/area/ruin/unpowered)

(1,1,1) = {"
aaaaaaaaaaaaaaaaaaaaaaaaaaaaaaaaaaaaaaaa
aaaaaaaaaaaaaaaaaaaaaaaaaaaaaaaaaaaaaaaa
aaaaaaaaaaaaaaaaaaaaaaaaaaaaaaaaaaaaaaaa
aaaaaaaaaaaaaaaaaaaaaaaaaaaaaaaaaaaaaaaa
aaaaaaaaaaaaaaaaaaaaaaaaaaaaaaaaaaaaaaaa
aaaaaaabbbaaaaaaaaaaaaaaaaaaaaaaaaaaaaaa
aaaaaabbbbaaaaaaaaaaaaaaaaaaaaaaaaaaaaaa
aaaaacccbbbbaaaaaaaaaaaaaaabaaaaaaaaaaaa
aaaaacccbbbbaaaaaaaaaaaaaabbbaaaaaaaaaaa
aaaaaaccbbaaaaaaaaaaaaaaaabbbaaaaaaaaaaa
aaaaaaaaaaaaaaaaaaaaaaaaaaaaaaaaaaaaaaaa
aaaaaaaaaaaaaaaaaaaaaaaabaaaaaaaaaaaaaaa
aaaaaaaaaaaaaaaaaaaaaaaaaaaaaaaaaaaaaaaa
aaaaaaaaaaaaabbdddddbbaaabbbbaaaaaaaaaaa
aaaaaaaaaaabbbbddddbbbbbbbbbbbaaaaaaaaaa
aaaaaaaaaaacbbbbbdbbbbbbbbbbbbbaaaaaaaaa
aaaaaaaaccccbbbbbbbbbccbbdddbbbaaaaaaaaa
aaaaaaaacccccbddbbccccccccccbccaaaaaaaaa
aaaaaaaaaccccbddbbeeeefeeeeecccaaaaaaaaa
aaaaaaaaacccccbbbggguhhijkelcccaaaaaaaaa
aaaaaaaaacccccbbbgmnhhhhhhelcccaaaaaaaaa
aaaaaaaaaccccbbbbopqhhhhhgelcccaaaaaaaaa
aaaaaaaaaccccbbdbbvhhhhrswelcaaaaaaaaaaa
aaaaaaaaaabccbbbbbeeeefetgeecaaaaaaaaaaa
aaaaaabaaabbbbbbbccccccccccccaaaaaaaaaaa
aaaaaaaaaabbbbbbbbbbcccccccccaaaaaaaaaaa
aaabaaaaaaaabbbbbbbbbccccaaaaaaaaaaaaaaa
aaaaaaaaaaaaabdbbdddbccccaaaaaaaaaaaaaaa
aaaaabbaaaaaaaaabdddbbbaaaaaaaaaaaaabaaa
aaaabbbaaaaaaaaaaaaaaaaaaaaaaaaaaaaaaaaa
aaaabbaaaaaaaaaaaaaaaabbbaaaaaaaaaccbbaa
aaaaaaaaaaaaaaaaaaaaadbbbbaaaaaaacccdbaa
aaaaaaaaaaaaaaaaaaadbbbbccaaaaaaacbdbaaa
aaaaaaaaaaaaaaaaaadbbbbcaaaaaaaaacbbbaaa
aaaaaaaaaaaaaaaaaddbbcccaaaaaaaaaaaaaaaa
aaaaaaaaaaaaaababbbbbcccaaaaaaaaaaaaaaaa
aaaaaaaaaaaaaabbbbbccccaaaaaaaaaaaaaaaaa
aaaaaaaaaaaaaabbbbdcccaaaaaaaaaaaaaaaaaa
aaaaaaaaaaaaaaabbcccccaaaaaaaaaaaaaaaaaa
aaaaaaaaaaaaaaaabccaaaaaaaaaaaaaaaaaaaaa
"}
